{
  "name": "prontera",
  "displayName": "Prontera, Capital de Rune-Midgard",
  "width": 100,
  "height": 100,
  "grid": [
    "TTTTTTTTTTTTTTTTTTTTTTTTTTTTTTTTTTTTTTTTTTTTTTT++++++TTTTTTTTTTTTTTTTTTTTTTTTTTTTTTTTTTTTTTTTTTTTTTT",
    "T..............................................++++++..............................................T",
    "T...T......T...T.T..............T..............++++++....T......................T........T.........T",
    "T..T................T.T....T...................++++++....................................T.........T",
    "T.............T.............T..T..........T....++++++.....................................T........T",
    "T......TT.................T.....T.....T........++++++.............T.....T..T..T.......T....T.......T",
    "T..............TT......T.......T.T.............++++++..................T.............T.............T",
    "T..............T.....T...TT...........T........++++++..............T....T..........................T",
    "T......T....T....T.............................++++++...........................T....T..*..T....T..T",
    "T....T....*****..T...T........T...TT..T........++++++............................T....***T*........T",
    "T.TT..T..***T**TT..........T.......T...........++++++......................T.........****T**.TT....T",
    "T........*******...............................++++++....T.....T...TT...T............**T****....T..T",
    "T.......*********...........TT.................++++++.........................T.....***TT**T*....T.T",
    "T........*******..............T................++++++................T...............*******T......T",
    "T.......T*******......................T........++++++...........T................T...*******.T.....T",
    "T......T..*****###########.T...................++++++......................###########*****..T.....T",
    "T.T.....TT..T..#...T.....#...T...T....T.TT.....++++++......T........T......#.TT......#.T*..........T",
    "T..........T...#..T..T...#.....................++++++........T.T......T....#.......T.#.............T",
    "T..............#.T.....T.#.T...................++++++......................#.T.T.TT..#...........T.T",
    "T........T.....#......T..#................T....++++++.........T..T....T....#...T.....#.....T.......T",
    "T.............T#.........#.....................++++++...........T...T....T.#.......T.#.............T",
    "T..............#.........#........T..T.........++++++....T...............T.#.........#.............T",
    "T...T..T.......#.........#.....T........T......++++++.............T........#.........#.............T",
    "T..............#....T.T..#.......TT....T...T...++++++................T.T...#...T.....#.............T",
    "T.T.T.........T#.........#.....................++++++......................#.........#.............T",
    "T....T.........###########.......T.............++++++.......T........T.....###########....T........T",
    "T.........................T.........T...T......++++++..............................................T",
    "T.................................T............++++++.........T......TT..T..............T..........T",
    "T....T.......T.....T..............T...TT.......++++++..................T...........................T",
    "T.........................T........T..T........++++++......T......T...............T................T",
    "T....T.....T........................T..........++++++...T..........T......................T.T......T",
    "T...T.T.....T....TT.........T..................++++++..............T.......T.......................T",
    "T........T....T.................T..........T...++++++....T.T.......................T...........T...T",
    "T...........T...............T...T.T............++++++...T............T..............T...........TT.T",
    "T..........T.....T.......T........T............++++++...T...........TT......T................T.TT..T",
    "T..T.........T...T....................T........++++++...T..................T........T..............T",
    "T..............T...............T........T......++++++...................................T..........T",
    "T...............T............T...T.............++++++.......T......................T...............T",
    "T.......T...TT......T..........................++++++.......T..........T..T...................T....T",
    "T..............T..........T..........TTT...T...++++++.................T...T..T.....................T",
    "T........................T.....................++++++............T....T............................T",
    "T...T.T.TT................T...........T....T...++++++..............................................T",
    "T....T...............T..T.........TT.T..T......++++++.........................................T....T",
    "T......................T.......................++++++.........T..........T..................T......T",
    "T...........................................FFFFFFFFFFFF...........................................T",
    "T...........................................F**********F...........................................T",
    "T...........................................F**********F...........................................T",
    "++++++++++++++++++++++++++++++++++++++++++++F**********F++++++++++++++++++++++++++++++++++++++++++++",
    "++++++++++++++++++++++++++++++++++++++++++++F**********F++++++++++++++++++++++++++++++++++++++++++++",
    "++++++++++++++++++++++++++++++++++++++++++++F****FF****F++++++++++++++++++++++++++++++++++++++++++++",
    "++++++++++++++++++++++++++++++++++++++++++++F****FF****F++++++++++++++++++++++++++++++++++++++++++++",
    "++++++++++++++++++++++++++++++++++++++++++++F**********F++++++++++++++++++++++++++++++++++++++++++++",
    "++++++++++++++++++++++++++++++++++++++++++++F**********F++++++++++++++++++++++++++++++++++++++++++++",
    "T...........................................F**********F...........................................T",
    "T...........................................F**********F...........................................T",
    "T...........................................FFFFFFFFFFFF...........................................T",
    "T............T..T.T.T...........T..............++++++................T..........T..................T",
    "T....................T.........T.....T.........++++++..............................................T",
    "T......T.T.T...T............T..................++++++......................T.........T.............T",
    "T.......................T........T.............++++++............TT...T....T...T..........T........T",
    "T.......T..T...........T.........T.............++++++......T............T.T..T................T....T",
    "T........................T....T................++++++...........T.T.T...........T..................T",
    "T.......................T...............T......++++++....T.TT............T.....................T...T",
    "T.........T..T.............T...................++++++..........T.T..........T.........T...T........T",
    "T.....T...............T..............T...T.T...++++++........T.....T.........T.....................T",
    "T..........................T........T..........++++++.....T................T..T.....TT....T........T",
    "T.................T.....................T......++++++........T..................................TT.T",
    "T..T...............................T.T.........++++++....................T..........T......T.......T",
    "T......T....T........T.......T........T........++++++................................TTTT..........T",
    "T........T......T.TT..T...............T........++++++.........T..............T......T..T...........T",
    "T......................T.....T.........T.......++++++......T.....T....................T.........T..T",
    "T.....T............T...T.....T......T.T........++++++..............................T........TT.....T",
    "T.........T............TTT.....TT.....T....T...++++++.....T.......T............T...........T...T...T",
    "T...T.............................T............++++++.....................T...T.T..T...............T",
    "T.........T...T...T.................T.T..T.....++++++........T.........T..T...T..........T.........T",
    "T..............###########T.........T..........++++++....TT............T...###########.............T",
    "T.T...T........#.....T...#T...T.....TTT........++++++..........T...........#..TT.....#.....T.......T",
    "T....T...T.....#.....T...#...............T.T...++++++.........T............#.........#....T........T",
    "T..T...........#......T..#.T.....T...T.........++++++................T.TT..#.......T.#T.T..........T",
    "T..............#T........#.....................++++++..................T...#.........#...........T.T",
    "T....TT........#......T..#.T...................++++++......................#.........#.T........T..T",
    "T...T..T.......#T......T.#....T................++++++........T..T..........#....T....#..T........T.T",
    "T...T..........#.......T.#.T..T................++++++......................#.........#.....TT...T..T",
    "T......T...T...#.........#.....T....T..........++++++.........T............#.........#.............T",
    "T..T......T.*..#.....T.T.#.....................++++++................T.....#T...T....#..*........T.T",
    "T.........*****###########.............T...T...++++++..........T...........###########**T**........T",
    "T....T...*******..........T..............T.....++++++................................T******.......T",
    "T......T.*******..........T.....TT.T...........++++++.............................T..*******.......T",
    "T..T....*********..............T........T......++++++..........T....................*********......T",
    "T.T.....T***T***.T.T......T..T..T..............++++++.........T..................T...*******.......T",
    "T........*******...................T...........++++++.....T......TT....T..T........T.******TT...TT.T",
    "T.........*****.T.....T..........TT..T.....T...++++++................T....T....T......**T**........T",
    "T...........*.T.................T...T..........++++++...................................*......T...T",
    "T....T..............T............T.....T.......++++++.......................T.......T.T........T.T.T",
    "T.....T................T.......................++++++...........................T..........T....T..T",
    "T.................T.T.....T............T.......++++++.......T................T........T............T",
    "T...........T........T...T........TT.T..T......++++++...................T.........TT.....T.........T",
    "T..............T..........TT...................++++++..............T......T........................T",
    "T..............................................++++++..............................................T",
    "TTTTTTTTTTTTTTTTTTTTTTTTTTTTTTTTTTTTTTTTTTTTTTTWWWWWWTTTTTTTTTTTTTTTTTTTTTTTTTTTTTTTTTTTTTTTTTTTTTTT"
  ],
  "warps": [
    {
      "x": 47,
      "y": 99,
      "width": 6,
      "height": 1,
      "targetMap": "prt_fild08",
      "targetX": 50,
      "targetY": 2
    }
  ],
  "spawns": [
    {
      "mobId": 1002,
      "name": "Lunatic Mascota",
      "x": 40,
      "y": 40,
      "count": 5,
      "friendly": true
    },
    {
      "mobId": 1001,
      "name": "Poring de Adorno",
      "x": 60,
      "y": 40,
      "count": 5,
      "friendly": true
    },
    {
      "mobId": 1002,
      "name": "Lunatic Mascota",
      "x": 40,
      "y": 60,
      "count": 5,
      "friendly": true
    },
    {
      "mobId": 1001,
      "name": "Poring de Adorno",
      "x": 60,
      "y": 60,
      "count": 5,
      "friendly": true
    }
  ]
}