{
  "name": "prt_fild08",
  "displayName": "Campo de Prontera (prt_fild08)",
  "width": 100,
  "height": 100,
  "grid": [
    "TTTTTTTTTTTTTTTTTTTTTTTTTTTTTTTTTTTTTTTTTTTTTTTWWWWWWTTTTTTTTTTTTTTTTTTTTTTTTTTTTTTTTTTTTTTTTTTTTTTT",
    "T...............................................+++++..............................................T",
    "T.T......TT..T.....T.........T..T...............+++++......................T.............TT....T.T.T",
    "T......T......T...T...T...T....T...T............+++++.............T..T.....T.TT....T.......T.T.T.T.T",
    "T....TT..T..T....T.T.....T......................+++++............T.........T....T.T...TT....T......T",
    "T......T.TT.T.......T..T......TT................+++++.............T.......T..TT...T.....T..T....T..T",
    "T.T........T...T..TT...T........................+++++................T..T....T....T......T.T...TT..T",
    "T........T..T.TT................T...............+++++...............T..T..T...T.T.........T........T",
    "T.T.T.....TT...T.....T.....T.......................+++++...............TT......TT......T..T....T...T",
    "T.....T........T.....T....T...T.T..................+++++...........T...........T.............T.T...T",
    "T....T...T..T.......T...T..........................+++++............T..T....T.TTTT...T...TT........T",
    "T......T....T............T....T....................+++++............T.......T..T...T...T.......T...T",
    "T......T....T.....T.........T.T....................+++++..........T....T.T.....T..........T........T",
    "T........T.T............T.....T..T.................+++++......................T........T.....TT..T.T",
    "T.T.......T...T.T..TT..TT..........................+++++..............T.T...TT......T..T...........T",
    "T....T..T...T......T..........T....................+++++.............T................TT........T..T",
    "T..........T.......TT...T.......................+++++.................T........T....T.T............T",
    "T.TTT......TT.T..T.T...............T............+++++............T....T...T............T...T.......T",
    "T.T...T..T.............TTT......................+++++..............TT....T..T...........T..........T",
    "T........T..T.....T....T...T....................+++++.................T..T.TTT.........T.T....T....T",
    "T.T...........T.....T...T...T...................+++++..............T.......T.......................T",
    "T..T......T..T..T........T...T..................+++++.............T..T..T.........T.....T....TT.TT.T",
    "T......T......TT.T..T.......T...................+++++................TT...T...T..T.......T..T.T..T.T",
    "T......T........T......T.........T..............+++++............T...T......TT..T........T.T.T.....T",
    "T..T......T..TT............T.......................+++++..........T..T.....TTTT.........T..T..T.T..T",
    "T..........T....T..T...T...........T...............+++++............T.TT.T...TT.T..T.........T.....T",
    "T.....T.........T...............T..................+++++............T.T..T........T..TT.T..........T",
    "T.....T..T....TT.................TT................+++++...........TTT..........T..................T",
    "T....TTT.....T.................T..T................+++++..............T.T..........T.T.........T...T",
    "T...........T.T...........T........................+++++................T.....T...TT..T.......T....T",
    "T..T........T.T.TT.T........T...T.T................+++++...........T.......T.....T.T............T..T",
    "T..T..TT....TT...........T.T..T....................+++++......................T.T.T..............T.T",
    "T..T..T..T..T.....TT......TT......T...................+++++..........T....T.T.TT.T.......TTT.T.....T",
    "T......T....T.T..T...........TT.T.....................+++++..........TT......T...T...T......TTT..T.T",
    "T.TT.........T....T.T.....T...T..T....................+++++.............TT.....T...................T",
    "T..T...T...........TT...T.........T...................+++++...............T...TT..T...TTTT....T....T",
    "T.....................................................+++++........................................T",
    "T.....................................................+++++........................................T",
    "T.....................................................+++++........................................T",
    "T.....................................................+++++........................................T",
    "T........................................................+++++.........************...............*T",
    "T........................................................+++++.......*******************.......****T",
    "T........................................................+++++.....********************************T",
    "T........................................................+++++....*********************************T",
    "T........................................................+++++..***********************************T",
    "T........................................................+++++*********............***************.T",
    "T........................................................++++********...................*******....T",
    "T........................................................++********................................T",
    "T..............................*********..............+++*********.................................T",
    "T...........................****************..........+*********...................................T",
    "T.........................************************************.....................................T",
    "T.......................*************************************......................................T",
    "T......................************************************........................................T",
    "T....................**********.........*****************++........................................T",
    "T...................********................***********++++........................................T",
    "T.................********............................+++++........................................T",
    "T...............********.................................+++++.....................................T",
    "T.............*********..................................+++++.....................................T",
    "T****.....***********....................................+++++.....................................T",
    "T*******************.....................................+++++.....................................T",
    "T*****************.......................................+++++.....................................T",
    "T***************.........................................+++++.....................................T",
    "T*************...........................................+++++.....................................T",
    "T....*****...............................................+++++.....................................T",
    "T.....................................................+++++........................................T",
    "T......T..T..T.....T.........T........................+++++..................T......T....T.T.T...T.T",
    "T.....T.......TT....T.T.....T....T....................+++++.....................TT.........T.......T",
    "T..........T..T....T......T.......TT..................+++++...................T.............T......T",
    "T....T.......T.TT.T....T....T.........................+++++........T...T.TT.......T..T.........T.T.T",
    "T......T.T.T.........TT...............................+++++.........T..TT....T....T......T....T....T",
    "T..........T........T..........T...T..................+++++...................T.....T..............T",
    "T..T....T........T......T.............................+++++.......T.T.............T.T.T.......T..T.T",
    "T...T............T..............T..T.....................+++++...TT...........T..............T...T.T",
    "T.......T......T.T...T.T....T............................+++++..........T...........T..T...T...T...T",
    "T.T.......T.T...............T............................+++++....T........T.T......T....TT........T",
    "T..............T......TT.T...TT.T........................+++++........T.T......T......T.....T..T...T",
    "T.....TT...........T.T...................................+++++......TT.T.T............TT...........T",
    "T........T..T..T..T.....T..T.............................+++++....T.T........T.T.........T.T.......T",
    "T...T.....T.TT........TT...T.T.TT........................+++++.....T.T...............T...T.........T",
    "T.T..T...................T..T............................+++++.....TT..T..T....TT..TT..............T",
    "T.TT.T...........T....T.T...................................+++++..T..T.T...T....T.......T.....T...T",
    "T...T............T..........T.T..T..........................+++++..T...........T.T......T..........T",
    "T..T........T.............T..T..............................+++++.......T...T....TT....T......T....T",
    "T.........TT........T...TT.TT.....T.........................+++++.........T..T...........T..T...T..T",
    "T.................T.........TT..............................+++++..T....T....TT.......T....T..T....T",
    "T........TTT.T..T............TTT............................+++++T..T..........T...................T",
    "T.....T.T...T.T.............T...............................+++++...T......T.....T....TT........T..T",
    "T......T..............T..........T.T........................+++++T...............T..TT...T...T.T.T.T",
    "T.T..TT........T.......T......TT..T............................+++++...............T.......TT....T.T",
    "T.T......T..T...............T.T.T..............................+++++...T...............T..T.TTT....T",
    "T.........T....T........T..........T...........................+++++T..T.....T.T..TTT...T.T........T",
    "T......T.T.T......T.........T....T.T...........................+++++.....T........T..TT.T.T....T...T",
    "T...........T.........T.T.......T..............................+++++.T......T..T....T..............T",
    "T.........TT.....T.......TT......T.............................+++++T.....T....T...............T...T",
    "T........................T......T..............................+++++...........T...............T...T",
    "T.......T.T....T............T...T..............................+++++T.............T.....T.....T.TT.T",
    "T......T..T..T.TTT.T..T.....................................+++++T....T..........T...T......T......T",
    "T..TT...TT...T....T....T.......TT...........................+++++TT......T....T.T....T....T...T.T..T",
    "T...........................................................+++++..................................T",
    "TTTTTTTTTTTTTTTTTTTTTTTTTTTTTTTTTTTTTTTTTTTTTTTTTTTTTTTTTTTT+++++TTTTTTTTTTTTTTTTTTTTTTTTTTTTTTTTTTT"
  ],
  "warps": [
    {
      "x": 47,
      "y": 0,
      "width": 6,
      "height": 1,
      "targetMap": "prontera",
      "targetX": 50,
      "targetY": 97
    }
  ],
  "spawns": [
    {
      "mobId": 1001,
      "name": "Poring",
      "count": 20,
      "x": null,
      "y": null
    },
    {
      "mobId": 1002,
      "name": "Lunatic",
      "count": 12,
      "x": null,
      "y": null
    },
    {
      "mobId": 1003,
      "name": "Baphomet Jr",
      "count": 5,
      "x": null,
      "y": null
    }
  ]
}