{
  "name": "prt_fild08",
  "displayName": "Campo de Prontera (prt_fild08)",
  "width": 30,
  "height": 30,
  "grid": [
    "TTTTTTTTTTTTTWWWWTTTTTTTTTTTTT",
    "T............................T",
    "T............................T",
    "T......TTTTTT......TTTTTT....T",
    "T......T....T......T....T....T",
    "T......T....T......T....T....T",
    "T......TTTTTT......TTTTTT....T",
    "T............................T",
    "T...***......................T",
    "T....***.....................T",
    "T.....***....................T",
    "T......***...................T",
    "T.......***..................T",
    "T........***........TTTT.....T",
    "T.........***.......T..T.....T",
    "T..........***......TTTT.....T",
    "T...........***..............T",
    "T............***.............T",
    "T.............***............T",
    "T..............***...........T",
    "T...............***..........T",
    "T................***.........T",
    "T.................***........T",
    "T..................***.......T",
    "T...................***......T",
    "T....................***.....T",
    "T............................T",
    "T............................T",
    "T............................T",
    "TTTTTTTTTTTTTTTTTTTTTTTTTTTTTT"
  ],
  "warps": [
    {
      "x": 13,
      "y": 0,
      "width": 4,
      "height": 1,
      "targetMap": "prontera",
      "targetX": 15,
      "targetY": 27
    }
  ],
  "spawns": [
    {
      "mobId": 1001,
      "name": "Poring",
      "count": 10,
      "x": null,
      "y": null
    },
    {
      "mobId": 1002,
      "name": "Lunatic",
      "count": 6,
      "x": null,
      "y": null
    },
    {
      "mobId": 1003,
      "name": "Baphomet Jr",
      "count": 2,
      "x": null,
      "y": null
    }
  ]
}
